███████████████
█       █     █
█ █ ███ ███ █ █
█ █ █   █   █ █
█ █ █████ ███ █
█ █       █   █
█ █████ ███ ███
█     █   █ █ █
█████ █ █ █ █ █
█     █ █ █   █
█ █████ █ █████
█   █ █ █ █   █
███ █ █ █ ███ █
█   █   █     █
███████████████
